floor has no description.
discarded pair of socks has no description.
slightly dirty shirt has no description.
computer has no description.
Inbox has no description.
Unread Email has no description.
corroded brass key has no description.
terminal has no description.
sub has no description.
Small shark has no description.
Medium shark has no description.
Large shark has no description.
fork has no description.
knife has no description.
dirty plate has no description.
wooden pillar has no description.
hut door has no description.
portal has no description.
fountain coins has no description.
Lighthouse - Ground Floor. has no ambient noise.
Lighthouse Basement has no ambient noise.
Research Station has no ambient noise.
Break Room has no ambient noise.
Printer Room has no ambient noise.
Great Library has no ambient noise.
Potion Lab has no ambient noise.
Wizzard's Bedroom has no ambient noise.

Crossroads
An Interactive Fiction by Ian Meeder
Release 1 / Serial number 190112 / Inform 7 build 6L02 (I6/v6.33 lib 6/12N) SD

Rotunda
You stand in a huge circular chamber made entirely out of large stones that look like they came right out of the medieval ages. The room is even lit by torches. Looking up, you see the ribbed vaulted ceiling some 100 feet above you. The floor is decorated with various colored mosiac tiles in the shape of a compass rose.

There are archways leading to dim corridors to the northwest, northeast, east, southeast, south, and southwest whereas to the west and north are doors. The west door looks to be a normal wooden door you would expect to see in an old castle. You know, from all those castles you've visited. The northern door is at least twice as large as the other door and is ornately carved.

You can see a compass here.

>take all
placard: I don't think Martha would appreciate that.
Meerkat Edition of National Geographic: Taken.
June 2008 Edition of People Magazine: Taken.

>turn on computer
You switch the computer on.

>read email
From: Ian Meeder [mailto:imeeder@cox.net]
Sent: Friday, August 01, 2014 1:16 AM
To: imeeder@cox.net
Subject: A gift for you.

Just think what will come around on your actual birthday! O_o

-Blubbers

As you read the email you start to feel a little woozy.

>l
The world is starting to spin again. You do not enjoy this.

>l
Ugh.

>l
Wait.

>l
This doesn't feel right. Not that it usually does, but this is different.

>l
The cool white color of your room is being replaced by yellows and browns as your vision beings to spin faster and faster.

>l
You think you're going to be sick.

>l
Slowly, as you fight back an overwhelming puking sensation, the spinning stops.

>l
You take a moment to compose yourself before you look at your surroundings.

>l
This is definitely not your room. It is cold and made of stone and you don't like it.

>l
A paper flutters down through the air and lands on the ground infront of you. You notice that it is the email that your good friend Ian sent you. Flipping it over, you read:

"P.S. I recommend grabbing some graph paper and a pen - maps can be so useful."

>l
--- Welcome to Connor's Crazy Adventure Fun Time ---

The Rotunda
A huge circular room made entirely out of large stones that look like they came right out of the medieval ages. The room is even lit by torches. Looking up, you see the ribbed vaulted ceiling some 100 feet above you. The floor is decorated with various colored tiles in the shape of a compass rose. There are archways at each of the cardinal and ordinal directions except for west and north. The eastern door looks to be a normal wooden door you would expect to see in an old castle. The northern door is at least twice as large as the other door and is ornately carved.

>x rose
A large compass rose that takes up nearly half of the floor.

>x ornate
A huge double door. It is at least twice your height. The carvings in its face seem to be of the orient. Despite its size, there are two silver handles at waist level for someone of normal proportions.

>open ornate
It seems to be locked.

>open door
Which do you mean, the ornate door or the small door?

>open small door
You open the small door.

>e
Gondola Station
You walk down a long and winding corridor lit by more torches at a steady slope. Finally you begin to see light from outside and emerge.

You are in a huge alcove built into the side of a massive east-facing cliff. Looking out, all you can see is fog in all directions. Below you can hear the distant sound of waves chrashing against the cliff face somewhere below this fog. Above you is a large cable attached to the cliff that stretches out eastward and disappears into the fog. To the west of you is the door leading back to the Rotunda.

A metal joint is fassened to the ground next to the loading dock.

You can also see a lever handle here.

>w
Rotunda
A huge circular room made entirely out of large stones that look like they came right out of the medieval ages. The room is even lit by torches. Looking up, you see the ribbed vaulted ceiling some 100 feet above you. The floor is decorated with various colored tiles in the shape of a compass rose. There are archways at each of the cardinal and ordinal directions except for west and north. The eastern door looks to be a normal wooden door you would expect to see in an old castle. The northern door is at least twice as large as the other door and is ornately carved.

>w
Storage Room
A storage room.

>e
Rotunda
A huge circular room made entirely out of large stones that look like they came right out of the medieval ages. The room is even lit by torches. Looking up, you see the ribbed vaulted ceiling some 100 feet above you. The floor is decorated with various colored tiles in the shape of a compass rose. There are archways at each of the cardinal and ordinal directions except for west and north. The eastern door looks to be a normal wooden door you would expect to see in an old castle. The northern door is at least twice as large as the other door and is ornately carved.

>e
Gondola Station
You are in a huge alcove built into the side of a massive east-facing cliff. Looking out, all you can see is fog in all directions. Below you can hear the distant sound of waves chrashing against the cliff face somewhere below this fog. Above you is a large cable attached to the cliff that stretches out eastward and disappears into the fog. To the west of you is the door leading back to the Rotunda.

A metal joint is fassened to the ground next to the loading dock.

You can also see a lever handle here.

>x joint
A metal joint that looks like it can be rotated. It seems to be missing a part where there is a large hexagonal hole.

>rotate email
Nothing obvious happens.

>take
What do you want to take?

>take handle
Taken.

>take joint
That's fixed in place.

>attach handle to joint
You attach the handle to the joint.

>l
Gondola Station
You are in a huge alcove built into the side of a massive east-facing cliff. Looking out, all you can see is fog in all directions. Below you can hear the distant sound of waves chrashing against the cliff face somewhere below this fog. Above you is a large cable attached to the cliff that stretches out eastward and disappears into the fog. To the west of you is the door leading back to the Rotunda.

A lever is fassened to the ground next to the loading dock.

>rotate lever
(the lever)
It is fixed in place.

>x lever
(the lever)
The lever is switched off.

>switch lever
(the lever)
The lever is now off.

>switch lever
(the lever)
The lever is now off.

>xlever
That's not a verb I recognise.

>x lever
(the lever)
The lever is switched off.

>x handle
You see nothing special about the lever handle.

>undo
Gondola Station
[Previous turn undone.]

>undo
Gondola Station
[Previous turn undone.]

>undo
The use of "undo" is forbidden in this game.

>l
Gondola Station
You are in a huge alcove built into the side of a massive east-facing cliff. Looking out, all you can see is fog in all directions. Below you can hear the distant sound of waves chrashing against the cliff face somewhere below this fog. Above you is a large cable attached to the cliff that stretches out eastward and disappears into the fog. To the west of you is the door leading back to the Rotunda.

A lever is fassened to the ground next to the loading dock.

* * *

>e
Gondola Station
You walk down a long and winding corridor lit by more torches at a steady slope. Finally you begin to see light from outside and emerge.

You are in a huge alcove built into the side of a massive east-facing cliff. Looking out, all you can see is fog in all directions. Below you can hear the distant sound of waves chrashing against the cliff face somewhere below this fog. Above you is a large cable attached to the cliff that stretches out eastward and disappears into the fog. To the west of you is the door leading back to the Rotunda.

A metal joint is fassened to the ground next to the loading dock.

>trun joint
That's not a verb I recognise.

>turn joint
You try, but you cannot get enough leverage.

>rotate joint
You try, but you cannot get enough leverage.

>switch joint
You try, but you cannot get enough leverage.

>flip joint
That's not a verb I recognise.

>take handle
Taken.

>attach handle to joint
You attach the handle to the joint.

>actions
Actions listing on.

>action
That's not a verb I recognise.

>l
[looking]
Gondola Station
You are in a huge alcove built into the side of a massive east-facing cliff. Looking out, all you can see is fog in all directions. Below you can hear the distant sound of waves chrashing against the cliff face somewhere below this fog. Above you is a large cable attached to the cliff that stretches out eastward and disappears into the fog. To the west of you is the door leading back to the Rotunda.

A lever is fassened to the ground next to the loading dock.

[looking - succeeded]

>actions
Actions listing on.

>actions off
Actions listing off.

>x lever
(the lever)
A pretty basic looking lever.

>switch lever
(the lever)

>x lever
(the lever)
A pretty basic looking lever.

>actions
Actions listing on.

>switch lever
(the lever)
[switching on the lever]
[(1) activating the lever]
[(1) activating the lever - succeeded]

[switching on the lever - failed]

>x lever
(the lever)
[examining the lever]
A pretty basic looking lever.

[examining the lever - succeeded]

>switch lever on
(the lever on)
[switching on the lever]
[(1) activating the lever]
[(1) activating the lever - succeeded]

[switching on the lever - failed]

>actions off
Actions listing off.

>switch on lever
(the lever)

>switch on lever
(the lever)

>switch lever
(the lever)

>switch lever
(the lever)

* * *

>x lever
(the lever)
A pretty basic looking lever.

>turn lever
(the lever)

>x lever
(the lever)
A pretty basic looking lever.

* * *

>w
The Rotunda
A huge circular room made entirely out of large stones that look like they came right out of the medieval ages. The room is even lit by torches. Looking up, you see the ribbed vaulted ceiling some 100 feet above you. The floor is decorated with various colored tiles in the shape of a compass rose. There are archways at each of the cardinal and ordinal directions except for west and north. The eastern door looks to be a normal wooden door you would expect to see in an old castle. The northern door is at least twice as large as the other door and is ornately carved.

>w
(first opening the small door)

Storage Room
A storage room.

You can see a flashlight here.

>take
(the flashlight)
Taken.

>e
The Rotunda
A huge circular room made entirely out of large stones that look like they came right out of the medieval ages. The room is even lit by torches. Looking up, you see the ribbed vaulted ceiling some 100 feet above you. The floor is decorated with various colored tiles in the shape of a compass rose. There are archways at each of the cardinal and ordinal directions except for west and north. The eastern door looks to be a normal wooden door you would expect to see in an old castle. The northern door is at least twice as large as the other door and is ornately carved.

>s
Alcove
You come to a staircase that seems endless, but continue up it anyway. After many minutes of climbing, you reach the top where you notice that the corridor made of carved stone has turned into an earthen tunnel. Following it, you are led outside.

You stand outside in a small alcove built high into a south face of a steep mountain. Looking out, all you can see is a layer of clouds maybe 100 feet below you. There is no way of telling how high up you are.  The sun is low in the sky and is casting long shadows on everything. Following the cliff northwest is a small path which disappears into into the rock. North, above you, is the long staircase leading back to the rotunda.

>e
You can't go that way.

>w
Dark Cave
It is too dark to see anything in this cave. The only thing visible is the opening to the southeast.

>nw
It is too dark to do that.

>n
It is too dark to do that.

>s
It is too dark to do that.

>look
It is too dark to do that.

>x
What do you want to examine?

>switch on flashlight
You turn the flashlight on.

>e
Alcove
You stand outside in a small alcove built high into a south face of a steep mountain. Looking out, all you can see is a layer of clouds maybe 100 feet below you. There is no way of telling how high up you are.  The sun is low in the sky and is casting long shadows on everything. Following the cliff northwest is a small path which disappears into into the rock. North, above you, is the long staircase leading back to the rotunda.

>switch on flashlight
The flashlight is already turned on.

>e
You can't go that way.

>w
Dark Cave
A small dark cave in the side of the mountain. There are stalagmites and stalactites bursting from the ground and ceiling. To the northwest, the cave appears to continue. To the southwest is the opening leading back to the alcove.

>turn off flashlight
You turn the flashlight off.

>jump
It is too dark to do that.

>nw
It is too dark to do that.

>e
Alcove
You stand outside in a small alcove built high into a south face of a steep mountain. Looking out, all you can see is a layer of clouds maybe 100 feet below you. There is no way of telling how high up you are.  The sun is low in the sky and is casting long shadows on everything. Following the cliff northwest is a small path which disappears into into the rock. North, above you, is the long staircase leading back to the rotunda.

>wn
That's not a verb I recognise.

>se
You can't go that way.

>se
You can't go that way.

>turn on flashlight
You turn the flashlight on.

>turn off flashlight
You turn the flashlight off.

>jump
You jump on the spot.

>look
Alcove
You stand outside in a small alcove built high into a south face of a steep mountain. Looking out, all you can see is a layer of clouds maybe 100 feet below you. There is no way of telling how high up you are.  The sun is low in the sky and is casting long shadows on everything. Following the cliff northwest is a small path which disappears into into the rock. North, above you, is the long staircase leading back to the rotunda.

>x rod
You can't see any such thing.

>x handle
You can't see any such thing.

>nw
You can't go that way.

>w
Dark Cave
It is too dark to see anything in this cave. The only thing visible is the opening to the southeast.

>turn on flashlight
You turn the flashlight on.

>look
Dark Cave
A small dark cave in the side of the mountain. There are stalagmites and stalactites bursting from the ground and ceiling. To the northwest, the cave appears to continue. To the southwest is the opening leading back to the alcove.